#domain
hospital-cld
#levelname
CLDOpen
#colors
blue: 0
red: 1
#initial
++++++++++++++++++++
+0+   +            +
+ + +    +  +    +++
+ +   +   + +      +
+    ++ + + +    + +
+ +   +   +      + +
+ ++  ++ +++   + + +
+ +                +
+      +    ++     +
+    +        ++   +
+ +     + + +  +   +
+ +         + ++   +
+                  +
+                  +
+ + ++  + +   ++++ +
+ +       +      + +
+ ++  ++  ++  ++ + +
+ +            +   +
+ +    +++  ++    1+
++++++++++++++++++++
#goal
++++++++++++++++++++
+ +   +            +
+ + +    +  +    +++
+ +   +   + +      +
+1   ++ + + +    + +
+ +   +   +      + +
+ ++  ++ +++   + + +
+ +               0+
+      +    ++     +
+    +        ++   +
+ +     + + +  +   +
+ +         + ++   +
+                  +
+                  +
+ + ++  + +   ++++ +
+ +       +      + +
+ ++  ++  ++  ++ + +
+ +            +   +
+ +    +++  ++     +
++++++++++++++++++++
#end
